63 7
###############################################################
#                                #    R                       #
#                      @   #     #   R                        #
#                      =   #     # R                          #
# =                        #      RR                    !     #
#                          #                                  #
###############################################################