63 7
###############################################################
#                       R        #                            #
#                      R   #     #                            #
#                      =   #     #                            #
# =                        #           @   =             !    #
#                          #                                  #
###############################################################