63 7
###############################################################
#                      R     R   #                            #
#                       R  #   R #                            #
#                      =   #    R#                            #
# =                        #           @   =             !    #
#                          #                                  #
###############################################################