23 13
#######################
#         O.          #
#   .     |       !   #
####O-#####           #
#                     #
#                     #
#         #############
#         #           #
#         #           #
#         |   @   =   #
#        .O           #
#         #           #
#######################