26 11
##########################
#              #         #
#              O.        #
#      @       |         #
#              #         #
#              #     .   #
####################-O####
#                        #
#   !                    #
#                        #
##########################
