38 9
#####################################
#             #                     #
#             #                     #
#      =      #                     #
#                        R     !    #
#      @      #                     #
#             #                     #
#             #                     #
#####################################