46 8
####################     #####################
#                  #     #                   #
#                  #######                   #
#                  O                         #
#                  |                         #
#                  #######                   #
#                  #     #                   #
####################     #####################